TileSize: 32.0
Rows: 20
Columns: 40
2222222222222222222222222222222222222222
2000000000000000000000000000000000000002
2000000000000000000000000000000000000002
2000000000000000000000000000000000000002
2000000020002000200020002000200000000002
2000000000000000000000000000000000000002
2000000000000000000000000000000000000002
2000000020002000200020002000200000000002
2000000000000000000000000000000000020002
2000000000000000000000000000000000020002
2000000020002000200020002000200000000002
2000000000000000000000000000000000000002
2000000000000000000000000000000000000002
2000000020002000200020002000200000000002
2000000000000000000000000000000000000002
2000000000000000000000000000000000000002
2000000000000000000000000000000000000002
2000000000000000000000000000000000000002
2000000000000000000000000000000000000002
2222222222222222222222222222222222222222

----5----5----5----5----5----5----5----5----5----5
^0--------^10-------------------^30---------------------------^60