TileSize: 32.0
Rows: 20
Columns: 40
0000000000000000000000000111111111111111
0222222222222220000000000000000000000001
0220000000000000000000000000000000000001
0020000000000000000000000000000000000001
0220000000000000000000000000000000000001
2220000002222222222222222222000000000001
2200000002000000000002000002000000000001
2200000000000002000002000002000000000001
1200000002000002000002000002000000000001
1200000002222222000002222002000000000001
1200000002000000000000000002000000000001
1200000002000002000000000002000000000001
1200000002022222222220222202000000000001
1200000000000000000000000000000000000001
1200000000000000000000000000000000000001
1200000000000000000000000000000000000001
1200000000000000000000000000000000000001
1200000000000000000000000000000000000001
1200000000000000000000000000000000000001
1211111111111111111111111111111111111111
----5----5----5----5----5----5----5----5----5----5
^0--------^10-------------------^30---------------------------^60