TileSize: 32.0
Rows: 20
Columns: 40
1111111111111111111111111111111111111111
1000000000000000000000000000000000000001
1000000000000000000000000000000000000001
1000000000000000000000000000000000000001
1000000000000000000000000000000000000001
1000000002222222222222000000000000000001
1000000002000002000002000000000000000001
1000000002000000000002000000000000000001
1000000002000002000002000000000000000001
1000000002000002000002000000000000000001
1000000000000000000000000000000000000001
1000000000000000000000000000000000000001
1000000000002222222220000000000000000001
1000000000000000000000000000000000000001
1000000000000000000000000000000000000001
1000000000000000000000000000000000000001
1000000000000000000000000000000000000001
1000000000000000000000000000000000000001
1000000000000000000000000000000000000001
1111111111111111111111111111111111111111
----5----5----5----5----5----5----5----5----5----5
^0--------^10-------------------^30---------------------------^60